****************
*A-------------*
*-------------->
*--------------*
*-------P------*
*-----------O--*
*--------------*
*******V********