
#m
0 8 16
2 1 1 
****************
*--------------*
*-------------->
*--------------*
*-------P---A--*
*-----------O--*
*--------------*
*******V********

#m
1 8 16
2 0 0
********^*******
*-------P------*
*--------------*
<--------------*
*--------------*
*--------------*
*--------------*
****************