


#m
0 8 16
2 0 0
****************
*A-------------*
*-------------->
*--------------*
*-------P------*
*-----------O--*
*--------------*
*******V********

#m
1 8 16
2 1 2
****************
*A-------------*
*-------------->
*-------P------*
*--------------*
*-----------O--*
*--------------*
*******V********